short_str	full_str
AAT	Anglo-Australian Telescope
ALMA	Atacama Large Millimeter/submillimeter Array
ATST	Advanced Technology Solar Telescope
Acanth.	Acanthocephala
Acar.	Acari
Algae	Algae
Amphib.	Amphibia
Amphip.	Amphipoda
Ann.	Annelida
Anopl.	Anoplura
Anth.	Anthozoa
Arachn.	Arachnida
Aran.	Aranei
Arth.	Arthropoda
Aves	Aves
BVDM	Bundesverband Druck und Medien
Bact.	Bacteria
Biv.	Bivalvia
Blatt.	Blattodea
Brach.	Brachiopoda
Branch.	Branchiopoda
Bry.	Bryozoa
Bryoph.	Bryophyta
CAM	(Computer-Aided Manufacturing)
CFHT	Canada-France-Hawaii Telescope
CTA	Cherenkov Telescope Array
C[m]	средняя скорость поршня
Ceph.	Cephalopoda
Cest.	Cestoda
Chaet.	Chaetognatha
Cil.	Ciliophora
Cirr.	Cirripedia
Coel.	Coelenterata
Col.	Coleoptera
Collemb.	Collembola
Cop.	Copepoda
Crust.	Crustacea
Cten.	Ctenophora
DKIST	Daniel K. Inouye Solar Telescope
Dec.	Decapoda
Derm.	Dermaptera
Dicot.	Dicotyledoneae
Dipl.	Diplura
Dipt.	Diptera
E-ELT	European Extremely Large Telescope
EHT	Event Horizon Telescope
ELT	Extremely Large Telescope
ESA	Европейское космическое агентство
ET	Einstein Telescope
Ech.	Echiurida
Echin.	Echinodermata
Emb.	Embioidea
Ephem.	Ephemeroptera
Euph.	Euphausiacea
FADEC	(Full Autority Digital Engine Control)
FAST	Five-hundred-meter Aperture Spherical Telescope
FK	фундаментальный каталог
FOGRA	Forschungsinstitut f~:ur medientechnologien e.V.
Fespa	F~1ed~1eration of European Screen Ptinters Association
Forschungsgesellschaft Druck e.V.	полиграфическое исследовательское общество
Fungi	Fungi
GBT	Green Bank Telescope либо Robert C. Byrd Green Bank Telescope
GMT	Giant Magellan Telescope
GTC	Gran Telescopio Canarias
Gastr.	Gastropoda
Grylloblatt.	Grylloblattidae
Gymn.	Gymnospermae
H.E.S.S.	High Energy Stereoscopic System
HET	Hobby
Hemichord.	Hemichordata
Het.	Heteroptera
Hir.	Hirudinea
Hom.	Homoptera
Hydr.	Hydrozoa
Hym.	Hymenoptera
ICC	International Color Consortium
IFRA	Inca Frey Research Association
IGAS	International Graphic Arts Show
IRD	Institute f~:ur rationale Unternehmensf~:urung in Druckindustrie
ISBD	International Standard Bibliographic Description
ISBN	International Standard Book Number
ISDS	International Serials Data System
ISO	International Standard Organisation
ISSN	International Standard Serials Number
Ins.	Insecta
Invert.	Invertebrata
Isop.	Isopoda
Isopt.	Isoptera
JCMT	James Clerk Maxwell Telescope
Kampt.	Kamptozoa
LAMOST	Large sky Area Multi-Object fibre Spectroscopic Telescope
LBT	Large Binocular Telescope
LOFAR	Low-Frequency Array
LSST	Large Synoptic Survey Telescope
Lep.	Lepidoptera
Lichen.	Lichenes
MAGIC	Major Atmospheric Gamma Imaging Cherenkov Telescopes
MARC	machine-readable cataloguing
MMT	Multiple Mirror Telescope
M[e]	эффективный крутящийся момент
M[j]	индикаторный крутящийся момент
Malloph.	Mallophaga
Mamm.	Mammalia
Mant.	Mantoptera
Mastig.	Mastigophora
Mecopt.	Mecoptera
Megal.	Megaloptera
Moll.	Mollusca
Monocot.	Monocotyledoneae
Monog.	Monogenea
Myr.	Myriapoda
Mys.	Mysidacea
NASA	Национальное управление по аэронавтике и исследованию космического пространства, США
NGF	фактор роста нервов
N[e]	эффективная мощность
N[j]	индикаторная мощность
N[n]	литровая мощность
N[u]	цилиндровая мощность
Nem.	Nematoda
Nemath.	Nemathelminthes
Nemert.	Nemertini
Neur.	Neuroptera
OCLC	Online Computer Library Center
OPAC	Online Public Access Catalog
Odon.	Odonata
Oligoch.	Oligochaeta
Onych.	Onychophora
Opil.	Opiliones
Opisth.	Opisthobranchia
Orth.	Orthoptera
Ostr.	Ostracoda
PSO	Process-Standard Offsetdruck
P[k]	абсолютное давление наддува
Phasm.	Phasmoptera
Phor.	Phoronida
Pisces	Pisces
Plac.	Placozoa
Plat.	Plathelminthes
Plec.	Plecoptera
Pog.	Pogonophora
Polych.	Polychaeta
Pros.	Prosobranchia
Prot.	Protozoa
Protura	Protura
Pseudoscorp.	Pseudoscorpiones
Psoc.	Psocoptera
Pterid.	Pteridophyta
Pulm.	Pulmonata
Pycn.	Pycnogonida
Rept.	Reptilia
Rhaph.	Rhaphidioptera
Rot.	Rotatoria
SALT	Southern African Large Telescope
SKA	Square Kilometre Array
SPT	South Pole Telescope
Sarc.	Sarcodina
Scorp.	Scorpiones
Scyph.	Scyphozoa
Sip.	Sipunculida
Siphon.	Siphonaptera
Spong.	Spongia
Stom.	Stomatopoda
Streps.	Strepsiptera
TMT	Thirty Meter Telescope
TNF	фактор некроза опухоли
TNG	Telescopio Nazionale Galileo
T[1/2]	период полувыведения, период полуэлиминации, период полураспада
Tard.	Tardigrada
Thys.	Thysanura
Thysan.	Thysanoptera
Trem.	Trematoda
Trich.	Trichoptera
Turb.	Turbellaria
UKIRT	United Kingdom Infra-Red Telescope
UKST	UK Schmidt Telescope
VDMA	Verband deutscher Maschinen und Anlagenban
VISTA	Visible and Infrared Survey Telescope for Astronomy
VLA	Very Large Array либо Karl G. Jansky Very Large Array
VLBA	Very Long Baseline Array
VLT	Very Large Telescope
V[h]	рабочий объем цилиндра
V[m]	максимальная скорость реакции
WAN	World Association of Newspapers
WSRT	Westerbork Synthesis Radio Telescope
Web	World Wide Web
Xiph.	Xiphosura
Zorapt.	Zoraptera
_h[e]	эффективный КПД
_h[j]	индикаторный КПД
_h[m]	механический КПД
_h[v]	коэффициент наполнения
comb.	combinatio
comb.n.	combinatio nova
drupa	Druck und Papier
f.	forma
fam.	familia
fam.n.	familia nova
g[e]	удельный эффективный расход топлива
g[i]	удельный индикаторный расход топлива
gen.	genus
gen.n.	genus novum
iV[h]	рабочий объем двигателя
p[e]	среднее эффективное давление
p[j]	среднее индикаторное давление
p[z]	максимальное давление сгорания
p[тр]	среднее давление трения
sp.	species
sp.n.	species nova
ssp.	subspecies
ssp.n.	subspecies nova
subfam.	subfamilia
subfam.n.	subfamilia nova
subgen.	subgenus
subgen.n.	subgenus novum
syn.n.	synonim novum
viscom	Viskal Commucation
А*	атлас
ААС	атомно-абсорбционная спектроскопия
ААСR	Anglo-American Cataloguing Rules
АБ	аккумуляторная батарея
АБЗ	асфальтобетонный завод
АВО	аппарат воздушного охлаждения
АВР	автоматический ввод резерва
АВС	акрилонитрилбутадиенстирол
АГ	асинхронный генератор
АГК	автоматический грузовой корабль
АГНС	автомобильная газонаполнительная станция
АД	асинхронный двигатель
АДТ	аэродинамическая труба
АЗС	автозаправочная станция
АИМ	амплитудно-импульсная модуляция
АКП	авиакосмическая промышленность
АЛС	автоматическая локомотивная сигнализация
АМ	амплитудная модуляция
АМС	автоматическая межпланетная станция
АОЭ	Астрономическая обсерватория им. В.П. Энгельгардта
АПВ	автоматическое повторное включение
АПК	агропромышленный комплекс
АПУ	алфавитно-предметный указатель alphabetic subject index
АРВ	автоматический регулятор возбуждения
АРН	автоматическое регулирование
АРУ	автоматическая регулировка усиления
АСДУ	автоматизированная система диспетчерского управления
АСК	автоматизированная система контроля
АСНТИ	автоматизированная система научно-технической информации
АСПО	асфальтосмолопарафиновые отложения
АСПТ	атомная станция промышленного теплоснабжения
АСР	аварийно-спасательные работы
АСС	аварийно-спасательные службы
АСУ ТП	автоматизированная система управления технологическим процессом
АСУД	автоматизированные системы управления движением
АСУДД	автоматизированная система управления дорожным движением
АСУТП	автоматизированная система управления технологическими процессами
АСФ	аварийно-спасательные формирования
АТБ	авиационная техническая база
АТП	автотранспортные предприятия
АТСС	автоматизированная транспортно-складская система
АТФаза	аденозинтрифосфатаза
АТЭЦ	атомная теплоэлектроцентраль
АФХ	амплитудно-фазовая характеристика
АХОВ	аварийно химически опасное вещество
АЦПУ	алфавитно-цифровое печатающее устройство
АЧР	автоматическая частота разгрузки
АЧХ	амплитудно-частотная характеристика
АЭМС	атомно-эмиссионная спектроскопия
АЭС	атомная электростанция
АЭУ	атомная энергетическая установка
Ав	авария
АрУ	ароматические углеводороды
БА	болезнь Альцгеймера
БАН	Библиотека Российской академии наук Russian Academy of Sciences Library
БВС	бортовая вычислительная система
БЕН	Библиотека по естественным наукам Российской академии наук Natural Sciences Library Russian Academy of Sciences
БЗ	база знаний knowledge base
БКК	большие космические конструкции
БМО	Большое Магелланово Облако
БПК	биологическая потребность в кислороде
БПУ	береговой производственный участок
БПФ	быстрое преобразование Фурье
БРПЛ	баллистическая ракета подводных лодок
БРСД	баллистическая ракета средней дальности
БРЭО	бортовое радиоэлектронное оборудование
БСА	Большая сканирующая антенна
БСВТ	Большой солнечный вакуумный телескоп
БТА	Большой телескоп альт-азимутальный
БТСРСП	ближняя тонкая структура рентгеновских спектров поглощения
БЦВМ	бортовая цифровая вычислительная машина
БЧ	белый чугун
В.	восток
ВАХ	вольт-амперная характеристика
ВГБИЛ	Всероссийская государственная библиотека иностранной литературы им. М.И.Рудомино M.I.Rudomino All-Russia State Library for Foreign Literature
ВГВ	высокий горизонт воды
ВГТД	вспомогательный ГТД
ВД	высокое давление
ВДС	вибрационно-диагностическая система
ВЗМО	высшая занятая молекулярная орбиталь
ВИМС	вторичная ионная масс-спектрометрия
ВИНИТИ РАН	Всероссийский институт научной и технической информации Российской академии наук All-Russia Institute for Scientific and Technical Information
ВИЧ	вирус иммунодефицита человека
ВИЭ	возобновляемые источники энергии
ВК	векторное квантование
ВКА	воздушно-космический аппарат
ВКД	внекорабельная деятельность
ВКР	вынужденное комбинационное рассеяние
ВКС	воздушно-космический самолет
ВН	высокое напряжение
ВНД	высшая нервная деятельность
ВНИИКИ	Всероссийский научно-исследовательский институт комплексной информации All-Russia Research Institute for Complex Information of Standardization and Quality
ВНИИПИ	Всероссийский научно-исследовательский институт патентной информации All-Russia Research Institute for Patent Information
ВНК	водонефтяной контакт
ВНС	вегетативная нервная система
ВНТИЦ	Всероссийский научно-технический центр All-Russia Scientific and Technical Information Centre
ВОК	волоконно-оптический кабель
ВОЛС	волоконно-оптическая линия связи
ВОМ	вал для отбора мощности
ВПМ	валочно-пакетирующая машина
ВПП	взлетно-посадочная полоса
ВПУ	водоподготовительная установка
ВРМБ	вынужденное рассеяние Мандельштама-Бриллюэна
ВРО	высокорадиоактивные отходы
ВРШ	винт регулируемого шага
ВСУ	вспомогательная силовая установка
ВТМ	валочно-трелевочная машина
ВУ	вычислительное устройство
ВУЗ	высшее учебное заведение
ВУС	водоугольная суспензия
ВУФ	вакуумный ультрафиолет
ВФХ	вольт-фарадная характеристика
ВФШ	винт фиксированного шага
ВХ	вибрационная характеристика
ВХР	водно-химический режим
ВЦ	вычислительный центр
ВЦМК "Защита"	Всероссийский центр медицины катастроф "Защита"
ВЦП	Всероссийский центр переводов научно-технической литературы и документации All-Russia Translation Centre of Scientific and Technical Literature and Documentation
ВШРА	вкладочно-швейно-резальный агрегат
ВЭ	водяной экономайзер
ВЭЖХ	высокоэффективная жидкостная хроматография
ВЭР	вторичные энергоресурсы
ВЭС	ветроэлектростанция
ВЭТСХ	высокоэффективная хроматография в тонком слое
ВЭТТ	высота эквивалентной теоретической тарелки
Вз	взлетный
ГА	гражданская авиация
ГАИШ	Государственный астрономический институт им. П.К. Штернберга
ГАЛ	гибкая автоматическая линия
ГАО	Главная астрономическая обсерватория РАН
ГАП	гибкое автоматизированное производство
ГАС	гидроакустическая станция
ГАУ	гидроаккумулирующая установка
ГАЭС	гидроаккумулирующая электростанция
ГВ	горючее вещество
ГВГ	генерация второй гармоники
ГГ	горючий газ
ГГС	государственная геодезическая сеть
ГД	гидродвигатель
ГЕОХИ	Институт геохимии и аналитической химии им. В.И. Вернадского РАН
ГЖ	горючая жидкость
ГЖХ	газожидкостная хроматография
ГЗУ	гидрозолоудаление
ГИН	генератор импульсных напряжений
ГИТ	генератор импульсных токов
ГКЛ	галактические космические лучи
ГКФ	Государственный коммуникативный формат
ГКШП	кривошипный горячештамповочный пресс
ГЛС	гидролокационная станция
ГМ	гидромотор
ГМП	гидромеханическая передача
ГНСС	глобальные
ГО	гражданская оборона
ГОК	горно-обогатительный комбинат
ГОТ	городской общественный транспорт
ГПА	газоперекачивающие агрегаты
ГПВРД	прямоточно-воздушный ракетный двигатель с горением в сверхзвуковом потоке
ГПЗ	гравитационный потенциал Земли
ГПМ	гибкий производственный модуль
ГПНТБ России	Государственная публичная научно-техническая библиотека России Russian State Public Library for Science and Technology
ГПНТБ СО РАН	Государственная публичная научно-техническая библиотека Сибирского отделения Российской академии наук
ГПС	гибкая производственная система
ГПТ	городской пассажирский транспорт
ГПУ	гексагональный плотноупакованный
ГПЯ	гибкая производственная ячейка
ГРП	гидравлический разрыв пласта
ГРЭС	государственная районная электростанция
ГСМ	горюче-смазочные материалы
ГСНТИ	Государственная система научно-технической информации
ГСО	геостационарная орбита
ГТД	газотурбинный двигатель
ГТЗА	главный турбозубчатый агрегат
ГТС	гиперзвуковой транспортный самолет
ГТУ	газотурбинная установка
ГТФ	гуанозинтрифосфорная кислота, гуанозинтрифосфат
ГХ	газовая хроматография
ГЦ	гидроцилиндр
ГЦК	гранецентрированный кубический
ГЦО	геоцентрическая орбита
ГЭС	гидроэлектростанция
ГЭТ	городской электрический транспорт
ГЭУ	гребная электрическая установка
ГелиоТЭС	солнечная тепловая электростанция
ДАУ	дистанционное автоматическое управление
ДВП	древесноволокнистая плита
ДВС	двигатель внутреннего сгорания
ДВЦ	дециметровые волны
ДГУ	дизель-генераторная установка
ДЗ	дистанционное зондирование
ДЗЗ	дистанционное зондирование Земли
ДЗЭ	детектор по захвату электронов
ДИП	детектор с ионизацией в пламени
ДМ	дождевальная машина
ДМЗ	древесно-массный завод
ДМСО	диметилсульфоксид
ДМФА	диметилформамид
ДНК	дезоксирибонуклеиновая кислота
ДНКаза	дезоксирибонуклеаза
ДНФ	дизъюнктивная нормальная форма
ДОЗ	деревообрабатывающий завод
ДОК	деревообрабатывающий комбинат
ДОС	дисковая операционная система
ДОФА	3-(3,4-дигидроксифенил) аланин
ДПД	добровольная пожарная дружина
ДПЛА	дистанционно пилотируемый летательный аппарат
ДПУ	датчик порода
ДПФ	дискретное преобразование Фурье
ДСП	древесно-стружечные плиты
ДСУ	десульфуризационная установка
ДСтП	древесностружечная плита
ДТА	дифференциальный термический анализ
ДТП	дорожно-транспортное происшествие
ДТС	дозвуковой транспортный самолет
ДТСРСП	дальняя тонкая структура рентгеновских спектров поглощения
ДХЭ	дихлорэтан
ДЭС	двойной электрический слой
ЕКА	Европейское космическое агентство
ЕСКК	единая система классификации и кодирования информации
ЕЭС	Единая энергетическая система
ЕЮО	Европейская южная обсерватория
ЖБ	железобетон
ЖБИ	железобетонные изделия
ЖБК	железобетонные конструкции
ЖД	жизнедеятельность
ЖК	жидкий кристалл
ЖКИ	жидкокристаллический индикатор
ЖКТ	желудочно-кишечный тракт
ЖРДУ	жидкостная ракетная двигательная установка
ЖХ	жидкостная хроматография
ЖЦИ	жизненный цикл изделия
ЖШУ	жидкое шлакоудаление
З.	запад
ЗАО	закрытое акционерное общество
ЗВ	загрязняющие вещества
ЗРУ	закрытое распределительное устройство
ЗС	защитные сооружения
ЗСУ	захватно-срезающее устройство
ЗТЛ	Зенит-телескоп ленинградский
ЗУ	запоминающее устройство
ЗУПВ	запоминающее устройство с произвольным выбором
ИАГ	иттрий-алюминиевый гранат
ИАП	интегрированное автоматизированное производство
ИАС	инженерно-авиационная служба
ИВА	инверсионная вольтамперометрия
ИВЛ	искусственная вентиляция легких
ИВС	информационно-вычислительная система
ИВЦ	информационно-вычислительный центр
ИДФ	инозиндифосфат
ИЗМИРАН	Институт земного магнетизма, ионосферы и распространения радиоволн им. Н.В. Пушкова РАН
ИК	инфракрасный
ИК-	инфракрасный
ИКИ	Институт космических исследований РАН
ИКО	индикатор кругового обзора
ИКС	инфракрасная спектроскопия
ИМ	импульсная модуляция
ИНАА	инструментальный нейтронно-активационный анализ
ИНАСАН	Институт астрономии РАН
ИНИОН	Институт научной информации по общественным наукам Российской академии наук Institute of Social Sciences Information
ИНС	инерциальная навигационная система
ИНЭ	индуктивный накопитель энергии
ИОЛ	интраокулярные линзы
ИОХ	ионнообменная хроматография
ИПЯ	информационно-поисковый язык indexing language
ИР	исследовательская ракета
ИРИ	избирательное распространение информации selective dissemination of information
ИСЗД	индивидуальные средства защиты дыхания
ИСЗФ	Институт солнечно-земной физики РАН, Сибирское отделение
ИСЛ	искусственный спутник Луны
ИСН	инерциальная система навигации
ИСО	Международная организация по стандартизации International Organization for Standardisation, ISO
ИСЭ	ионноселективный электрод
ИТ	информационные технологии
ИТЭФ	Институт теоретической и экспериментальной физики
ИФВЭ	Институт физики высоких энергий
ИФЗ	Институт физики Земли им. О.Ю. Шмидта РАН
ИФЛА	Международная федерация библиотечных ассоциаций и учреждений International Federation of Library Associations and Institutions, IFLA
ИХ	ионная хроматография
ИЦР	ионный циклотронный резонанс
ИЯИ	Институт ядерных исследований
КА	космический аппарат
КАРС	когерентное антистоксово рассеяние света
КБ	конструкторское бюро
КБС	клеевое бесшвейное скрепление
КВ	короткие волны, коротковолновый
КВЛ	конструктивная ватерлиния
КВО	критически важные объекты
КВП	короткие взлет и посадка
КД	круговой дихроизм
КЗО	квазизвездный объект
КЗП	Каталог заподозренных переменных звезд
КИА	контрольно-измерительная аппаратура
КИМ	кодо-импульсная модуляция
КИП	контрольно-измерительные приборы
КК	космический корабль
ККК	крупногабаритная космическая конструкция
ККМ	критическая концентрация мицеллообразования
КЛА	космический летательный аппарат
КМОП	комплементарная МОП-структура
КМЦ	карбоксиметилцеллюлоза
КНБ	кубический нитрид бора
КНФ	конъюнктивная нормальная форма
КО	космическая обсерватория
КПГ	компригированный природный газ
КПД	коэффициент полезного действия
КРС	крупный рогатый скот
КРУ	комплектное распределительное устройство
КРУЭ	элегазовое комплектное распределительное устройство
КСБ	комплексные системы безопасности
КСЗ	Каталог слабых звезд
КССВ	константа спин-спинового взаимодействия
КСЭ	космическая солнечная энергия
КТО	коэффициент теплоотдачи
КТП	комплектная трансформаторная подстанция
КТС	контейнерная транспортная система
КУФ-	крайний ультрафиолетовый
КХ	колоночная хроматография
КЭС	конденсационная электростанция
Км	композиция
КоA	кофермент A
КоQ	кофермент Q
КоА	кофермент A
КрАО	Крымская астрофизическая обсерватория РАН
ЛА	летательный аппарат
ЛАВВП	летательный аппарат вертикального взлета и посадки
ЛАКВП	летательный аппарат короткого взлета и посадки
ЛБВ	лампа бегущей волны
ЛБТ	легкосплавные бурильные трубы
ЛВЖ	легковоспламеняющаяся жидкость
ЛВС	локальная вычислительная сеть
ЛКМ	лакокрасочные материалы
ЛП	летное происшествие
ЛПК	лесопромышленный комбинат
ЛПХ	леспромхоз
ЛТР	локальное термодинамическое равновесие
МАС	Международный астрономический союз
МАСТЕР	Мобильная астрономическая система телескопов-роботов
МБА	межбиблиотечный абонемент interlibrary loan
МБВ	Международное бюро времени
МБР	межконтинентальная баллистическая ракета
МБУ	морская буровая установка
МВЛ	местные воздушные линии
МГГ	международный геофизический год
МГГС	Международный геодезический и геофизический союз
МГД	магнитогидродинамический
МГД-	магнитогидродинамический
МГДЭС	магнитогидродинамическая электростанция
МГС	Международное геофизическое сотрудничество
МГУ	Московский государственный университет им. М. В. Ломоносова
МГЭ	метод граничных элементов
МДС	магнитодвижущая сила
МИБК	метилизобутилкетон
МИИГАиК	Московский институт инженеров геодезии, аэрофотосъемки и картографии
МКС	Международная космическая станция
МКЭ	метод конечных элементов
МЛФС	меламиноформальдегидная смола
ММ	математическое моделирование
ММА	метилметакрилат
МММ	магнитомягкий материал
ММО	Малое Магелланово Облако
ММП	межпланетное магнитное поле
ММТ	Многоканальный мониторинговый телескоп
МНК	метод наименьших квадратов
МО-ЛКАО	молекулярных орбиталей
МОС	металлоорганические соединения
МПЗ	магнитное поле Земли
МПК	Международная патентная классификация International Patent Classification, IPC
МПО	металл-оксид-полупроводник
МРТ	магнитно-резонансная томография
МС-среда	среда Мурасиге-Скуга
МСА	международная стандартная атмосфера
МСВЗ	Международная служба вращения Земли
МСВИ	масс-спектрометрия вторичных ионов
МСУ	мусоросжигательная установка
МТП	машинно-тракторный парк
МУ	магнитный усилитель
МФС	мочевиноформальдегидная смола
МФУ	многофункциональные устройства
МЦ	метилцеллюлоза
МЦНТИ	Международный центр научной и технической информации International Centre for Scientific and Technical Information, ICSTI
МЧС	Министерство РФ по делам гражданской обороны чрезвычайных ситуаций и ликвидации последствий стихийных бедствий
МЭ	метиловый эфир
МЭК	метилэтилкетон
МЭРП	механически закрепляемые режущие пластины
Мб	мембрана
НАД	никотинамидадениндинуклеотид
НАДФ	никотинамидадениндинуклеотидфосфат
НАДФН	никотинамидадениндинуклеотидфосфат восстановленный
НВ	несущий винт
НВИЭ	нетрадиционные и возобновляемые источники энергии
НВМО	низшая вакантная молекулярная орбиталь
НГВ	низкий горизонт воды
НГДУ	нефтегазодобывающее управление
НГКМ	нефтегазоконденсатное месторождение
НД	низкое давление
НИИ	научно-исследовательский институт
НИИЯФ	Научно-исследовательский институт ядерной физики
НИОКР	научно-исследовательские и опытно-конструкторские работы
НИС	научно-исследовательское судно
НИЦ	научно-исследовательский центр
НК	неразрушающий контроль
НМД	накопитель на магнитном диске
НН	низкое напряжение
НОД	наибольший общий делитель
НОК	наименьшее общее кратное
НОТ	научная организация труда
НП	национальный парк
НПБ	надувные подушки безопасности
НПВО	нарушенное полное внутреннее отражение
НПЗ	нефтеперерабатывающий завод
НПК	национальные патентные классификации national patent classifications, NPC
НПО	научно-производственное объединение
НПУ	нефтепроводное управление
НРО	низкорадиоактивные отходы
НСА	насосно-силовой агрегат
НТ	небесные тела
НТВ	несуще-тянущий винт
НТР	научно-техническая революция
НТЦ	научно-технический центр
НФ	неподвижная фаза
НЧ	низкая частота, низкочастотный
ОА	орбитальный аппарат
ОАО	открытое акционерное общество
ОАПВ	однофазное АПВ
ОАСУ	отраслевая автоматизированная система управления
ОБЖ	обеспечение безопасности жизнедеятельности
ОВ	отравляющее вещество
ОД	оптический диск
ОИЯИ	Объединенный институт ядерных исследований
ОК	орбитальный комплекс
ОКБ	опытно-конструкторское бюро
ОКПЗ	Общий каталог переменных звезд
ОКР	опытно-конструкторские работы
ОКС	орбитальная космическая станция
ОКТ	оптическая когерентная томография
ОКТ-А	ОКТ с ангиографией
ОЛ	орбитальная лаборатория
ОМ	орбитальный модуль
ОМП	определение места повреждения
ОНЧ	очень низкая частота
ООО	общество с ограниченной ответственностью
ООС	охрана окружающей среды
ОПЗУ	оптическое программируемое запоминающее устройство
ОПН	ограничитель перенапряжения
ОПО	опасные производственные объекты
ОРЗ	острые респираторные заболевания
ОРУ	открытое распределительное устройство
ОРЭ	одновременно-раздельная эксплуатация
ОСК	орбитальная система координат
ОСТ	отраслевой стандарт
ОТ	общественный транспорт
ОТО	общая теория относительности
ОТЭС	океаническая ТЭС
ОУНБ	областная универсальная научная библиотека regional universal research library
ОХВ	опасное химическое вещество
ОЦК	объемноцентрированный кубический
ОЧ	октановое число
ОЭ	объект экономики
ОЭА	олигоэфиракрилаты
ПА	пожарный автомобиль
ПААГ	полиакриламидный гель
ПАВ	поверхностно-активное вещество
ПАН	полиакрилонитрил
ПАУ	полициклические ароматические углеводороды
ПАЭС	пневмоаккумулирующая электростанция
ПАкВ	поверхностная акустическая волна
ПВА	поливинилацетат
ПВД	подогреватель высокого давления
ПВДХ	поливинилиденхлорид
ПВЗ	параметры вращения Земли
ПВО	противовоздушная оборона
ПВС	поливиниловый спирт
ПВФ	поливинилфторид
ПВХ	поливинилхлорид
ПГ	парогенератор
ПГУ	парогазовая установка
ПДМС	полидиметилсилоксан
ПЗП	призабойная зона пласта
ПЗУ	программируемое запоминающее устройство
ПИ	пожарный извещатель
ПИ-регулятор	пропорционально-интегральный регулятор
ПИ-управление	пропорционально-интегральное управление
ПИА	проточно-инжекционный анализ
ПИД	пропорционально-интегрально-дифференциальный
ПИД-регулятор	пропорционально-интегрально-дифференциальный регулятор
ПИД-управление	пропорционально-интегрально-дифференциальное управление
ПКП	потенциалы концевой пластинки
ПЛО	противолодочная оборона
ПЛТ	поворотнолопастная турбина
ПМ	пневмомотор
ПМР	протонный магнитный резонанс
ПМС	путевая машинная станция
ПН	полезная нагрузка
ПНД	подогреватель низкого давления
ПНС	периферическая нервная система
ПОУГ	первичная открытоугольная глаукома
ППП	пакет прикладных программ
ППТ	передача постоянного тока
ПР	промышленные роботы
ПРО	противоракетная оборона
ПРУ	противорадиационное укрытие
ПС	пограничный слой
ПТ	паровая турбина
ПТК	природно-территориальный комплекс
ПТМ	подъемно-транспортная машина
ПТУ	паротурбинная установка
ПТУР	противотанковая управляемая ракета
ПТФЭ	политетрафторэтилен
ПФ	подвижная фаза
ПЦ	пневмоцилиндр
ПЧ	преобразователь частоты
ПЭ	полиэтилен
ПЭВМ	персональная ЭВМ
ПЭГ	полиэтиленгликоль
ПЭР	прямые эксплуатационные расходы
ПЭТФ	полиэтилентерефталат
ПЭФ	полиэфиры
РАО	радиоактивные отходы
РАТАН-600	Радиотелескоп Академии наук
РБ	ремни безопасности
РБА	Российская библиотечная ассоциация Russian Library Association
РВ	рулевой винт
РГБ	Российская государственная библиотека
РГПБ	Российская государственная патентная библиотека
РЕЦ*	рецензия
РЗ	релейная защита
РЗМ	редкоземельные металлы
РИР	ремонтно-изоляционные работы
РКА	Российское космическое агентство
РКП	Российская книжная палата Russian Book Chamber
РКТ	ракетно-космическая техника
РКТС	ракетно-космическая транспортная система
РЛ-	радиолокационный
РЛБО	радиолокатор бокового обзора
РЛС	радиолокационная станция
РЛСА	радиолокатор с синтезированной апертурой
РМ	ручная машина
РН	ракета-носитель
РНБ	Российская национальная библиотека Russian National Library
РНК	рибонуклеиновая кислота
РНКаза	рибонуклеаза
РНС	радионавигационная станция
РО	радиоактивные отходы
РОО	радиационно-опасный объект
РОТ	радиально-осевая турбина
РОУ	редукционно-охладительная установка
РОЭ	реакция оседания эритроцитов
РПН	регулирование под нагрузкой
РРЛ	радиорелейная линия
РС	рассеянный склероз
РСДБ	радиоинтерферометрия со сверхдлинной базой
РСТА	рентгеноструктурный анализ
РСУ	реактивная система управления
РСЧС	единая государственная система предупреждения и ликвидации последствий чрезвычайных ситуаций
РТГ	радиоизотопный термоэлектрический генератор
РТИ	резино-технические изделия
РТК	роботизированный технологический комплекс
РТП	руководитель тушения пожара
РУ	распределительное устройство
РУД	рычаг управления двигателем
РФА	рентгенофазовый анализ
РФЛА	рентгенофлуоресцентный анализ
РФЭС	рентгеновская фотоэмиссионная спектроскопия
РЭА	радиоэлектронная аппаратура
РЭМ	растровый электронный микроскоп
РЭП	радиоэлектронное противодействие
РЭФ*	реферат из иностранного РЖ
С*	стандарт*
С.	север
С.-В.	Северо-Восток
С.-З.	Северо-Запад
САD	(Computer-Aided Design)
САО	Специальная астрофизическая обсерватория РАН
САП	спеченный алюминиевый порошок
САПК	средство для автономного перемещения космонавтов
САР	система автоматического регулирования
САС	система аварийного спасения
СБ	солнечная батарея
СБИС	сверхбольшая интегральная система
СБТ	стальные бурильные трубы
СВ	сточные воды
СВВП	самолет вертикального взлета и посадки
СВД	сверхвысокое давление
СВН	сверхвысокое напряжение
СВП	судно на воздушной подушке
СВС	самораспространяющийся высокотемпературный синтез
СГ	синхронный генератор
СДНФ	совершенная дизъюнктивная нормальная форма
СЖО	система жизнеобеспечения
СЗК	средства защиты коллективные
СИБИД	Система стандартов по информации, библиотечному и издательскому делу Standards System for Information, Librarianship and Publishing Trade
СИЗ	средства индивидуальной защиты
СИЗОД	средства индивидуальной защиты органов дыхания
СИО	справочно-информационное обслуживание reference information service
СИС	средняя интегральная схема
СКВВП	самолет короткого взлета и вертикальной посадки
СКВП	самолет короткого взлета и посадки
СКИ	изопреновый каучук
СКЛ	солнечные космические лучи
СКМС	бутадиен(дивинил)метилстирольный каучук
СКН	бутадиен(дивинил)нитрильный каучук
СКНФ	совершенная конъюнктивная нормальная форма
СКО	среднеквадратичное отклонение
СКС	бутадиен(дивинил)стирольный каучук
СКУ	уретановый каучук
СКЭП	этилен-пропиленовый каучук
СКЭПТ	этилен-пропиленовый тройной каучук
СМ	синхронная машина
СМЖ	спинномозговая жидкость
СМИ	средства массовой информации
СМК	система массовой коммуникации
СМО	система массового обслуживания
СМПВ	судно с малой площадью ватерлинии
СН	собственные нужды
СНИПП	санитарные нормы и правила
СНО	средняя наработка на отказ
СНС	спутниковая навигационная система
СНЧ	сверхнизкая частота
СОВП	самолет с обычными характеристиками взлета и посадки
СОТР	система обеспечения теплового режима
СОЭ	скорость оседания эритроцитов
СПГ	сжиженный природный газ
СПГГ	свободнопоршневой генератор газа
СПД	свободнопоршневой двигатель
СПИД	синдром приобретенного иммунодефицита
СПК	судно на подводных крыльях
СППР	система поддержки принятия решений Decision Support System, DSS
СПС	сверхзвуковой пассажирский самолет
СРК	содорегенерационный котлоагрегат
СС	станция слежения
ССП	самосогласованного поля
ССРТ	Сибирский солнечный радиотелескоп
СТМ	сверхтвердые материалы
СТО	специальная теория относительности
СТОА	станция технического обслуживания
СТОП	Солнечный телескоп оперативных прогнозов
СТР	система терморегулирования
СТС	сверхзвуковой транспортный самолет
СФМ	спектрофотометрия
СФХ	сверхкритическая флюидная хроматография
СЦБ	сигнализация, централизация, блокировка
СЧ	серый чугун
СЭ	солнечный элемент
СЭУ	судовая энергетическая установка
Система СИД	система станок - инструмент - деталь
Ст	сталь
ТБО	твердые бытовые отходы
ТБФ	трибутилфосфат
ТВ ТСО	телевизионные технические средства охраны
ТВВД	турбовинтовентиляторный двигатель
ТВН	техника высоких напряжений
ТВС	тепловыделяющая сборка
ТВЭЛ	тепловыделяющий элемент
ТВлД	турбовентиляторный двигатель
ТГ	трудногорючее вещество
ТГА	термогравиметрический анализ
ТГФ	тетрагидрофуран
ТДС	тесная двойная система
ТЗХ	турбина заднего хода
ТК	турбокомпрессор
ТКА	транспортный космический аппарат
ТКК	транспортный космический корабль
ТКС	транспортная космическая система
ТМ	телеметрический
ТММ	термомеханическая древесная масса
ТН	трансформатор напряжения
ТНД	турбина низкого давления
ТНУ	теплонасосная установка
ТОЛП	технология и оборудование литейного производства
ТПК	территориально-производственный комплекс
ТПМ	тоннелепроходческая машина
ТПП	технологическая подготовка производства
ТРВ	терморегулирующий вентиль
ТРД	турбореактивный двигатель
ТРДД СВСД	ТРДД со сверхвысокой степенью двухконтурности
ТРДДФ	ТРДД с форсажной камерой
ТРТ	твердое ракетное топливо
ТСД	турбина среднего давления
ТСХ	тонкослойная хроматография
ТЦХМ	тетрацианохинодиметан
ТШУ	твердое шлакоудаление
ТЭ	топливный элемент
ТЭБ	топливно-энергетический баланс
ТЭД	тяговый электродвигатель
ТЭК	топливно-энергетический комплекс
ТЭН	трубчатый электронагреватель
ТЭО	транспортно-экспедиционное обслуживание
ТЭП	термоэмиссионный преобразователь
ТЭР	топливно-энергетические ресурсы
ТЭЦ	теплоэлектроцентраль
ТЭлП	ТЭлГ)
ТЯР	термоядерный реактор
ТЯЭC	термоядерная электростанция
УАТС	учрежденческая автоматическая телефонная станция
УБТ	утяжеленные бурильные трубы
УВ	углеводород
УВД	управление воздушным движением
УГ	уходящие газы
УЗИ	ультразвуковое исследование
УМГ	управление магистральными газопроводами
УМН	управление магистральными нефтепроводами
УПО	управление пожарной охраны
УР	управляемая ракета
УФ	ультрафиолетовый
УФ-	ультрафиолетовый
УЧПУ	устройство числового программного управления
ФАП	фазовая автоподстройка
ФАР	фазированная антенная решетка
ФЕС	фильтрационно-емкостные свойства
ФИАН	Физический институт им. П.Н. Лебедева РАН
ФКСЗ	Фундаментальный каталог слабых звезд
ФМ	фазовая модуляция
ФНО	фактор некроза опухоли
ФРН	фактор роста нервов
ФСУ	фазосмещающее устройство
ФЭ	фотоэлемент
ФЭЛ	фотоэлектрический элемент
ФЭС	фотоэлектронная спектроскопия
ФЭУ	фотоэлектронный умножитель
Фемто-ЛАСИК	лазерный интрастромальный фемтокератомилез, фемто-лазерная коррекция зрения
ХГ	хлоргидрат
ХИ	холодильник-излучатель
ХИТ	химический источник тока
ХМС	хроматомасс-спектрометрия
ХПК	химическое потребление кислорода
ХПЯ	химическая поляризация ядер
ХТММ	химико-термомеханическая масса
ХТС	химикотехнологические системы
ХФ	Хартри-Фока
ЦАП	цифроаналоговый преобразователь
ЦБЗ	цементобетонный завод
ЦБК	целлюлозно-бумажный комбинат
ЦБП	целлюлозно-бумажная промышленность
ЦБС	централизованная библиотечная система centralized library system
ЦВА	циклическая вольтамперометрия
ЦВД	цилиндр высокого давления
ЦВДС	совмещенные цилиндры высокого и среднего давления
ЦВМ	цифровая вычислительная машина
ЦГ	циклогексан
ЦДС	Центральная диспетчерская служба
ЦКС	циркулирующий кипящий слой
ЦЛ	целлюлоза
ЦММ	цифровая модель местности
ЦМР	цифровая модель рельефа
ЦНД	цилиндр низкого давления
ЦНИИГАиК	Центральный научно-исследовательский институт геодезии, аэросъемки и картографии им. Ф.Н. Красовского
ЦНС	центральная нервная система
ЦНТИ	центр научно-технической информации Scientific and Technical Information Centre
ЦП	центральный процессор
ЦПМ	цифровая печатная машина
ЦСД	цилиндр среднего давления
ЦСТОР	централизованная система технического обслуживания и ремонта
ЦУП	центр управления полетом
ЦЧ	цетановое число
ЧМ	частотная модуляция
ЧМТ	черепно-мозговая травма
ЧПУ	числовое программное управление
ЧС	чрезвычайная ситуация
ШАЛ	широкие атмосферные ливни
ШИМ	широтно-импульсная модуляция
ШО	шиффово основание
ЩОМ	щебнеочистительная машина
ЭГД	электрогидродинамический
ЭДС	электродвижущая сила
ЭДТА	этилендиаминтетрауксусная кислота
ЭЗС	электрозарядные станции
ЭИ	экспресс-информация Express Information
ЭИМ	электроизоляционный материал
ЭК	энергокомпания
ЭКоГ	электрокортикография
ЭЛТ	электронно-лучевая трубка
ЭМ	электронный микроскоп, электронная микроскопия
ЭМГ	электромиография
ЭО	экологическое образование
ЭОП	электронно-оптический преобразователь
ЭП	электропривод
ЭПР	электронный парамагнитный резонанс
ЭПС	электроподвижной состав
ЭСП	электронные спектры поглощения
ЭУ	энергетическая установка
ЭХГ	электрохимический генератор
ЭХЗ	электрохимическая защита
ЭХО	электрохимическая обработка
ЭЦ	электрическая централизация
ЭЦВМ	электронная цифровая вычислительная машина
ЭЭ	этиловый эфир
ЭЭС	электроэнергетическая система
ЭЯДР	электронно-ядерный двойной резонанс
Ю.	юг
Ю.-В.	Юго-Восток
Ю.-З.	Юго-Запад
ЯГР	ядерный гамма-резонанс
ЯКР	ядерный квадрупольный резонанс
ЯОД	язык описания данных
ЯР	ядерный реактор
ЯТ	ядерное топливо
ЯЭО	ядерный эффект Оверхаузера
а. е.	астрономическая единица
абс.	абсолютный
адм.	административный
арх.	архипелаг
ас-	аттосекундный
бельг. фр.	бельгийский франк
библ.	библиография, библиографический
биол.	биологический
биофиз.	биофизический
биохим.	биохимический
бух.	бухта
в т. ч.	в том числе
в-во	вещество
в. д.	восточная долгота
в. ц.	высота центров
в.д.	высокое давление
в.м.т.	внутренняя
в.р.в.	валовая регистровая вместимость
в/а	внутриартериально
в/б	внутрибрюшинно
в/в	внутривенно
в/ж	внутрижелудочково
в/к	внутрикожно
в/м	внутримышечно
в/с	внутрисердечно
вариац.	вариационный
вдхр.	водохранилище
волн.	волновой
вост.	восточный
вуз	высшее учебное заведение
г.	город
геогр.	географический
геол.	геологический
геоморфол.	геоморфологический
геофиз.	геофизический
гидрогеол.	гидрогеологический
гл.	глава
гл. обр.	главным образом
гос.	государственный
гп.	грузоподъемность
гравитац.	гравитационный
давл.	давление
дам-	декаметровый
двт	дедвейт
диам.	диаметр
диффер.	дифференциальный
дкм-	декаметровый
дм-	дециметровый
др.	другой, другие
ед.	единица
ед. SNU	единица солнечного потока нейтрино
емк.	емкость
ж. д.	железная дорога, железнодорожный
ж.-б.	железобетонный
з-д	завод
з-к	заповедник
з. д.	западная долгота
з.х.	задний ход
зал.	залив
зап.	западный
зоол.	зоологический
и пр.	и прочие
и т. д.	и так далее
ил.	иллюстрация
интегр.	интегральный
ихтиол.	ихтиологический
к-р	конденсатор
к. з.	короткое замыкание
к.з.	короткое замыкание
кан.	канал
картогр.	картографический
качеств.	качественный
кв.	квадратный
когер.	когерентный
кол-во	количество
количеств.	количественный
конф.	конференция
конфигурац.	конфигурационный
конц-ия	концентрация
коэф.	коэффициент
кпд	коэффициент полезного действия
кр	крейсерская
кр/м	кручений на 1 м
куб.	кубический
м-	метровый
м.	масштаб
м. кр.	максимальный крейсерский
м. п.	максимальный продолжительный
магн.	магнитный
макс.	максимальный
максим.	максимальный
мас.%	процент по массе
мас.ч.	массовая часть
масс. ч.	часть по массе
матем.	математический
мед.	медицинский
мед.-геогр.	медико-географический
мес.	месяц
метеорол.	метеорологический
метод наим. кв.	метод наименьших квадратов
методол.	методологический
мех.	механический
мин.	минимальный
миним.	минимальный
млн	миллион
млн. д.	миллионных долей
млрд	миллиард
мм-	миллиметровый
мм.	масштабы
мод.	модель
мол. в.	молекулярный вес
мол. м.	молекулярная масса
мол. масса	молекулярная масса
мол.в.	молекулярный вес
морфол.	морфологический
мощн.	мощность
н.-и.	научно-исследовательский
н.д.	низкое давление
н.м.т.	наружная
надотр.	надотряд
надсем.	надсемейство
напр.	например
науч.	научный
науч.-техн.	научно-технический
нац.	национальный
неорг.	неорганический
нефт.	нефтяной
нс-	наносекундный
о-ва	острова
о.	остров
об-во	общество
об.%	процент по объему
обл.	область
оз.	озеро
ок.	около
оптим.	оптимальный
орган.	органический
относит.	относительный
отр.	отряд
отрицат.	отрицательный
отт./ч	оттиск/час
охл.	охлаждающий, охлаждаемый
п-ов	полуостров
п. в.	почти всюду
п. н.	почти наверное
п. п. функция	почти периодическая функция
п.к.в.	поворот коленчатого вала
п/к	подкожно
п/о	перорально
парал.	параллельный
парц.	парциальный
пат.	патент
пл.	плотность
подкл.	подкласс
подотр.	подотряд
подсем.	подсемейство
пож.	пожарный
потенц.	потенциальный
пр.	пролив
пред.	предельный
преф.	префектура
прив.	приведенный
прим.	применение
пров.	провинция
пс-	пикосекундный
р-р	раствор
р-ция	реакция
р. м. ц.	расстояние между центрами
рРНК	рибосомная РНК
расч.	расчетный
рег. т.	регистровые тонны
рег.т.	регистровые тонны
релятив.	релятивистский
рис.	рисунок
с. в.	случайная величина
с. х.	сельское хозяйство, сельскохозяйственный
с.ш.	северная широта
св-во	свойство
сев.	северный
сем.	семейство
скв.	скважина
см-	сантиметровый
см.	смотри
соц.-экон.	социально-экономический
спец.	специальный
ср. кв.	средняя квадратическая
ст.	станция
стр-во	строительство
стр.	страница
субмм-	субмиллиметровый
т-р	трансформатор
т-ра	температура
т-рный	температурный
т. абс.	температура абсолютная
т. возг.	температура возгонки
т. воспл.	температура воспламенения
т. всп.	температура вспышки
т. е.	то есть
т. зам.	температура замерзания
т. заст.	температура застывания
т. исп.	температура испарения
т. к.	так как
т. кип.	температура кипения
т. конд.	температура конденсации
т. крит.	температура критическая
т. н.	так называемый
т. обр.	таким образом
т. отв.	температура отверждения
т. пл.	температура плавления
т. разл.	температура разложения
т. стекл.	температура стеклования
тРНК	транспортная РНК
табл.	таблица
тыс.	тысяча
у.т.	условное топливо
уд. в.	удельный вес
ур-ние	уравнение
ур. моря	уровень моря
ф-ла	формула
ф-т	факультет
ф. ст.	фунт стерлингов
физ.	физический
физ.-биол.	физико-биологический
физ.-геогр.	физико-географический
физ.-мат.	физико-математический
физ.-техн.	физико-технический
физ.-хим.	физико-химический
фин.г.	финансовый год
фр.	франк
фс-	фемтосекундный
х-ка	характеристика
х.	холодная
х. в.	химические волокна
х. х .	холостой ход
х. х.	холостой ход
х. ч.	химически чистый
х.-б.	хлопчатобумажный
х.-пр.	хлопкопрядильный
х.-тк.	хлопкоткацкий
хим.	химический
хоз-во	хозяйство
хоз.	хозяйственный
хр.	хребет
ц.м.	центр масс
ч.р.в.	чистая регистровая вместимость
швейц. фр.	швейцарский франк
э.д.с.	электродвижущая сила
эквив.	эквивалентный
экз.	экземпляр
экол.	экологический
экон.	экономический
экон.-геогр.	экономико-географический
экспоненц.	экспоненциальный
эл.	электрический
эпидемиол.	эпидемиологический
эф.	эффективный
ю. ш.	южная широта
юж.	южный
